**********  
*P       *  
*        *  
*        *  
*     *  *  
*    *M  *  
*   *    *  
*        *  
*       G*  
**********  
